# # # # # # # # # # # # # # # # # # # # # # # # # # # # # # # # #
# - - - - - - - - - - - - - - - - - - - - - - - - - - - - - - - #
# - # - # - # - # - # - # - # - # - # - # - # - # - # - # - # - #
# - - - - - - - - - - - - - - - - - - - - - - - - - - - - - - - #
# - # - # - # - # - # - # - # - # - # - # - # - # - # - # - # - #
# - - - - - - - - - - - - - - - - - - - - - - - - - - - - - - - #
# - # - # - # - # - # - # - # - # - # - # - # - # - # - # - # - #
# - - - - - - - - - - - - - - - - - - - - - - - - - - - - - - - #
# - # - # - # - # - # - # - # - # - # - # - # - # - # - # - # - #
# - - - - - - - - - - - - - - - - - - - - - - - - - - - - - - - #
# - # - # - # - # - # - # - # - # - # - # - # - # - # - # - # - #
# - - - - - - - - - - - - - - - - - - - - - - - - - - - - - - - #
# - # - # - # - # - # - # - # - # - # - # - # - # - # - # - # - #
# - - - - - - - - - - - - - - - - - - - - - - - - - - - - - - - #
# - # - # - # - # - # - # - # - # - # - # - # - # - # - # - # - #
# - - - - - - - - - - - - - - - - - - - - - - - - - - - - - - - #
# - # - # - # - # - # - # - # - # - # - # - # - # - # - # - # - #
# - - - - - - - - - - - - - - - - - - - - - - - - - - - - - - - #
# - # - # - # - # - # - # - # - # - # - # - # - # - # - # - # - #
# - - - - - - - - - - - - - - - - - - - - - - - - - - - - - - - #
# - # - # - # - # - # - # - # - # - # - # - # - # - # - # - # - #
# - - - - - - - - - - - - - - - - - - - - - - - - - - - - - - - #
# - # - # - # - # - # - # - # - # - # - # - # - # - # - # - # - #
# - - - - - - - - - - - - - - - - - - - - - - - - - - - - - - - #
# - # - # - # - # - # - # - # - # - # - # - # - # - # - # - # - #
# - - - - - - - - - - - - - - - - - - - - - - - - - - - - - - - #
# - # - # - # - # - # - # - # - # - # - # - # - # - # - # - # - #
# - - - - - - - - - - - - - - - - - - - - - - - - - - - - - - - #
# - # - # - # - # - # - # - # - # - # - # - # - # - # - # - # - #
# - - - - - - - - - - - - - - - - - - - - - - - - - - - - - - - #
# - # - # - # - # - # - # - # - # - # - # - # - # - # - # - # - #
# - - - - - - - - - - - - - - - - - - - - - - - - - - - - - - - #
# # # # # # # # # # # # # # # # # # # # # # # # # # # # # # # # #
