# # # # # # # # # # # # # # # # # # # # # # # # # # # # # # # # #
# - - - - - - - - - - - - - - - - - - - - - - - - - - - - - - - #
# - # - # - # - # - # - # - # - # - # - # - # - # - # - # - # - #
# - - - - - - - - - - - - - - - - - - - - - - - - - - - - - - - #
# - # - # - # - # - # - # - # - # - # - # - # - # - # - # - # - #
# - - - - - - - - - - - - - - - - - - - - - - - - - - - - - - - #
# - # - # - # - # - # - # - # - # - # - # - # - # - # - # - # - #
# - - - - - - - - - - - - - - - - - - - - - - - - - - - - - - - #
# - # - # - # - # - # - # - # - # - # - # - # - # - # - # - # - #
# - - - - - - - - - - - - - - - - - - - - - - - - - - - - - - - #
# - # - # - # - # - # - # - # - # - # - # - # - # - # - # - # - #
# - - - - - - - - - - - - - - - - - - - - - - - - - - - - - - - #
# - # - # - # - # - # - # - # - # - # - # - # - # - # - # - # - #
# - - - - - - - - - - - - - - - - - - - - - - - - - - - - - - - #
# - # - # - # - # - # - # - # - # - # - # - # - # - # - # - # - #
# - - - - - - - - - - - - - - - - - - - - - - - - - - - - - - - #
# - # - # - # - # - # - # - # - # - # - # - # - # - # - # - # - #
# - - - - - - - - - - - - - - - - - - - - - - - - - - - - - - - #
# - # - # - # - # - # - # - # - # - # - # - # - # - # - # - # - #
# - - - - - - - - - - - - - - - - - - - - - - - - - - - - - - - #
# - # - # - # - # - # - # - # - # - # - # - # - # - # - # - # - #
# - - - - - - - - - - - - - - - - - - - - - - - - - - - - - - - #
# - # - # - # - # - # - # - # - # - # - # - # - # - # - # - # - #
# - - - - - - - - - - - - - - - - - - - - - - - - - - - - - - - #
# - # - # - # - # - # - # - # - # - # - # - # - # - # - # - # - #
# - - - - - - - - - - - - - - - - - - - - - - - - - - - - - - - #
# - # - # - # - # - # - # - # - # - # - # - # - # - # - # - # - #
# - - - - - - - - - - - - - - - - - - - - - - - - - - - - - - - #
# # # # # - # - # - # - # - # - # - # - # - # - # - # - # - # - #
# - - - # - - - - - - - - - - - - - - - - - - - - - - - - - - - #
# - # - # # # # # # # # # # # # # # # # # # # # # # # # # # # - #
# - # - - - - - - - - - - - - - - - - - - - - - - - - - - - - - #
# # # # # # # # # # # # # # # # # # # # # # # # # # # # # # # # #
