# # # # # # # # # # # # # # # # # # # # # # # # # # # # # # # # #
# - - - - - - - - - - - - - - - - - - - - - - - - - - - - - - - #
# - # # # # # # # # # # # # # # # # # # # # # # # # # - # # # - #
# - # - - - - - - - - - - - - - - - - - - - - - - - - - - - - - #
# - # - # - # - # - # - # # # # # - # - # # # # # - # # # # # - #
# - # - # - # - # - # - # - - - # - # - # - - - # - # - - - # - #
# - # - # # # - # # # # # - # - # # # # # - # - # # # - # - # # #
# - # - - - # - # - - - - - # - - - # - - - # - # - - - # - - - #
# - # # # - # # # - # # # # # # # - # - # # # - # - # # # - # - #
# - # - # - - - # - - - - - # - # - - - # - # - - - # - - - # - #
# - # - # # # - # # # - # - # - # - # - # - # # # # # # # # # - #
# - # - - - # - - - # - # - - - # - # - - - # - - - # - - - - - #
# - # - # - # # # - # # # - # # # - # - # - # - # - # - # - # # #
# - # - - - - - # - - - - - # - - - # - # - # - # - # - # - - - #
# - # - # - # - # # # - # - # # # # # - # - # - # - # - # - # # #
# - # - - - - - - - # - # - # - - - - - # - - - # - - - # - - - #
# - # - # - # - # - # # # - # - # - # # # # # # # # # # # # # - #
# - # - - - - - - - # - - - # - - - # - - - # - - - - - - - - - #
# - # - # - # - # - # - # # # # # # # - # - # # # # # # # # # - #
# - # - - - - - - - # - - - - - # - - - # - - - - - # - - - # - #
# - # - # - # - # - # # # - # - # - # - # # # - # # # - # - # - #
# - # - - - - - - - # - - - # - # - # - - - # - - - # - # - # - #
# - # - # - # - # - # - # # # # # # # # # - # # # - # - # - # - #
# - # - - - - - - - # - - - - - # - - - # - - - # - - - # - - - #
# - # - # - # - # # # # # - # - # - # - # # # - # # # - # - # - #
# - # - - - - - # - # - - - # - - - # - - - # - - - # - - - # - #
# - # - # - # # # - # - # # # # # - # - # - # # # - # # # - # - #
# - # - - - # - - - - - - - # - - - # - # - - - # - - - # - - - #
# - # # # # # # # # # # # # # - # - # - # # # - # # # - # # # # #
# - - - # - # - - - - - # - # - # - # - # - # - - - # - - - - - #
# - # - # - # - # - # - # - # - # - # - # - # # # - # # # - # # #
# - # - - - - - # - # - - - - - # - # - - - - - - - - - - - - - #
# # # # # # # # # # # # # # # # # # # # # # # # # # # # # # # # #
