# # # # # # # # # # # # # # # # # # # # # # # # # # # # # # # # #
# - - - - - # - - - # - - - - - - - - - - - # - - - # - - - - - #
# - # - # - # - # # # # # - # - # - # - # # # # # - # - # - # - #
# - - - - - # - - - # - - - # - # - # - - - # - - - # - - - - - #
# - # - # - # - # - # - # - # - # - # - # - # - # - # - # - # - #
# - - - - - # - # - - - # - - - # - - - # - - - # - # - - - - - #
# - # - # - # - # - # - # - # # # # # - # - # - # - # - # - # - #
# - - - - - # - - - # - - - - - # - - - - - # - - - # - - - - - #
# - # - # - # - # - # - # - # - # - # - # - # - # - # - # - # - #
# - - - - - # - # - - - # - # - - - # - # - - - # - # - - - - - #
# - # - # - # - # - # - # - # - # - # - # - # - # - # - # - # - #
# - - - - - # - # - # - # - # - # - # - - - # - - - # - - - - - #
# - # - # - # - # # # # # # # - # - # - # # # # # # # - # - # - #
# - - - - - # - # - # - - - - - - - - - # - # - # - # - - - - - #
# # # # # # # - # - # - # - # - # # # # # - # - # - # # # # # # #
# - - - - - - - # - - - # - # - - - # - # - - - # - - - - - - - #
# - # - # - # - # - # # # - # - # - # - # - # # # # # - # # # - #
# - # - # - # - # - - - # - # - - - # - # - - - # - - - - - - - #
# - # - # - # - # - # - # - # # # # # - # - # - # - # # # # # # #
# - # - - - - - # - # - - - - - - - - - - - # - # - # - - - - - #
# - # - # - # - # # # # # # # - # - # # # # # # # - # - # - # - #
# - # - # - # - - - # - - - - - # - - - - - # - - - # - - - - - #
# - # - # - # - # - # - # - # - # - # - # - # - # - # - # - # - #
# - # - - - - - # - - - # - # - # - # - # - - - # - # - - - - - #
# - # - # - # - # - # - # - # - # - # - # - # - # - # - # - # - #
# - # - # - # - - - # - - - - - # - - - - - # - - - # - - - - - #
# - # - # - # - # - # - # - # # # # # - # - # - # - # - # - # - #
# - # - - - - - # - - - # - - - # - - - # - - - # - # - - - - - #
# - # - # - # - # - # - # - # - # - # - # - # - # - # - # - # - #
# - - - # - # - - - # - - - # - - - # - - - # - - - # - - - - - #
# - # - # - # - # # # # # - # # # # # - # # # # # - # - # - # - #
# - # - - - - - - - # - - - - - - - - - - - # - - - # - - - - - #
# # # # # # # # # # # # # # # # # # # # # # # # # # # # # # # # #
